#,#,#,#,#,#,#,#,#
#,*, , , ,#, , ,#
#, , , , ,#, , ,#
#,#,#,O, ,O, , ,#
#, , ,*,S, , , ,#
#, , ,#, ,O,#, ,#
#, , ,O, , , , ,#
#, , , , , , , ,#
#,#,#,#,#,#,#,#,#