#,#,#,#,###,#,###,#,#,###,#,#
#,P 5,   , , ,#, , ,   , , ,#
#,*, , , ,   ,   , ,P 2, , ,#
#,#,#,#,O, , ,P 3,   , ,P 1,#
#, ,   ,   , , ,#,   ,#,#,#,#
#, ,P 3, ,#, ,#,#,   , ,P 1,#
#,#,#,#,   , ,O, ,   ,   , ,#
#,   ,   , ,O, ,#,   , ,#, ,#
#,   , ,#, ,   ,#,   ,#, , ,#
#,   , ,#,O,P 5, ,O, ,#,   ,#
#,S,P 0,#, ,#,O,P 2,O,#,P 0,#
#,#,#,#,###,#,###,#,#,###,#,#