###,###,###,###,###,###,###,###,###,###,###,###,###,###,###
###,###,###,###,S0 ,   ,   ,   ,   ,   ,###,###,*1 ,   ,###
###,###,###,###,   ,   ,   ,   ,   ,   ,###,###,   ,   ,###
###,###,###,###,   ,   ,   ,###,###,###,###,###,   ,   ,###
###,   ,   ,   ,   ,   ,   ,###,###,###,###,###,   ,   ,###
###,   ,   ,   ,   ,   ,   ,   ,   ,   ,###,###,   ,   ,###
###,   ,   ,   ,   ,   ,   ,   ,   ,   ,###,###,   ,   ,###
###,   ,   ,   ,   ,###,###,   ,   ,   ,   ,   ,   ,   ,###
###,   ,   ,   ,   ,###,###,   ,   ,   ,   ,   ,   ,   ,###
###,###,###,###,###,###,###,###,###,###,###,###,###,###,###