###,###,###,###,###,###,###,###,###,###,###,###,###,###
###,O  ,   ,###,P 6,###,   ,   ,#  ,   ,   ,   ,O  ,###
###,   ,   ,###,   ,###,   ,   ,   ,   ,   ,   ,   ,###
###,   ,   ,###,   ,###,   ,###,   ,###,O  ,   ,   ,###
###,   ,   ,   ,   ,###,   ,   ,   ,   ,   ,   ,   ,###
###,P 0,###,#  ,   ,###,O  ,   ,   ,   ,   ,   ,   ,###
###,   ,   ,   ,   ,###,   ,   ,   ,   ,   ,   ,   ,###
###,   ,   ,   ,   ,###,   ,#  ,   ,   ,  #,   ,#  ,###
###,   ,   ,   ,   ,###,   ,#  ,   ,   ,   ,   ,   ,###
###,S  ,   ,#  ,   ,###,P 0,O  ,*  ,O  ,   ,#  ,P 6,###
###,###,###,###,###,###,###,###,###,###,###,###,###,###