#,#,#,#,#,#,#,#,#,#,#,#,#
#,#, , , , , , , , , ,#,#
#, ,*, , , , , ,#,O30, , ,#
#, , ,O20,O21, , , ,#,O31, , ,#
#, , ,#,#, , , , ,*, , ,#
#, , , , , , , , , , , ,#
#, , , , , , ,S, , ,#,#,#
#, , ,O11,#, , , , , , ,O11,#
#, , ,O10,#, , ,#, , , ,O10,#
#,#, ,*, , , ,#, , ,*,#,#
#,#,#,#,#,#,#,#,#,#,#,#,#