###,###,###,###,###,###,###,###,###,###,###,###,###,###
###,   ,   ,   ,P 2,   ,   ,   ,   ,   ,   ,   ,   ,###
###,   ,   ,   ,   ,   ,   ,   ,   ,   ,###,   ,   ,###
###,###,###,###,   ,   ,   ,P 5,   ,   ,###,   ,   ,###
###,   ,*  ,###,   ,O  ,   ,   ,   ,   ,###,P 2,   ,###
###,   ,   ,###,   ,   ,   ,   ,   ,   ,###,###,###,###
###,   ,   ,###,###,###,O  ,   ,   ,   ,   ,   ,   ,###
###,   ,P 5,   ,   ,   ,###,   ,###,###,###,   ,   ,###
###,O  ,   ,   ,   ,S  ,###,   ,   ,   ,   ,   ,   ,###
###,###,###,###,###,###,###,###,###,###,###,###,###,###