#,#,#,#,#,#,#,#,#,#,#,#
#,*,S, , ,#, , , , , ,#
#, , , , ,O, , ,#,#, ,#
#,O, , , ,*, , , , , ,#
#, , ,O, , , ,O,*, , ,#
#,*, ,#, , , ,#, , , ,#
#,#,#,#,#,#,#,#,#,#,#,#