###,###,###,###,###,###,###,###,###,###,###,###,###,###,###,###
###,P 2,   ,   ,   ,###,   ,###,   ,   ,###,P 3,   ,###,*  ,###
###,*  ,###,   ,   ,###,*  ,   ,   ,   ,###,###,   ,###,   ,###
###,   ,###,   ,   ,###,   ,O  ,###,   ,###,   ,   ,   ,P 5,###
###,P 4,###,O  ,P 3,###,P 1,   ,   ,   ,###,P 4,###,   ,   ,###
###,###,###,###,###,###,###,###,###,###,###,###,###,###,###,###
###,   ,   ,*  ,   ,###,   ,P 0,   ,   ,###,   ,P 0,   ,P 1,###
###,P 5,   ,###,   ,###,   ,   ,   ,   ,###,*  ,   ,   ,O  ,###
###,   ,   ,   ,   ,###,   ,###,###,###,###,   ,###,###,###,###
###,O  ,###,O  ,   ,###,   ,   ,*  ,P 2,###,   ,   ,   ,S  ,###
###,###,###,###,###,###,###,###,###,###,###,###,###,###,###,###