###,###,###,###,###,###,###,###,###,###,###,###,###,###,###,###,###,###,###,###,###
###,O  ,*  ,###,   ,   ,S0 ,   ,   ,   ,   ,   ,   ,   ,   ,   ,   ,###,*  ,   ,###
###,   ,   ,   ,   ,   ,   ,   ,   ,###,   ,   ,*  ,   ,   ,   ,   ,###,   ,   ,###
###,   ,P 1,   ,   ,   ,   ,   ,   ,###,   ,   ,   ,   ,   ,*  ,   ,   ,   ,   ,###
###,   ,   ,   ,###,   ,   ,   ,P 1,   ,   ,   ,   ,   ,   ,###,   ,   ,O  ,   ,###
###,   ,   ,   ,*  ,   ,   ,   ,   ,   ,   ,   ,   ,   ,   ,   ,   ,   ,###,   ,###
###,   ,   ,   ,   ,   ,   ,###,   ,   ,P 3,   ,   ,   ,   ,   ,   ,   ,   ,   ,###
###,   ,   ,   ,   ,   ,   ,   ,   ,   ,   ,   ,   ,   ,   ,   ,   ,   ,   ,   ,###
###,   ,   ,   ,   ,   ,   ,   ,   ,   ,   ,   ,   ,###,   ,   ,   ,   ,   ,   ,###
###,P 0,###,   ,   ,   ,   ,   ,   ,   ,   ,###,   ,   ,   ,P 3,   ,   ,   ,   ,###
###,   ,   ,*  ,   ,###,   ,   ,   ,###,   ,   ,   ,   ,   ,   ,###,   ,*  ,   ,###
###,   ,   ,   ,   ,###,   ,   ,   ,   ,   ,*  ,   ,   ,   ,   ,###,###,   ,   ,###
###,   ,   ,   ,O  ,###,P 0,   ,   ,###,###,O  ,   ,   ,   ,   ,###,   ,   ,O  ,###
###,###,###,###,###,###,###,###,###,###,###,###,###,###,###,###,###,###,###,###,###