#,#,#,#,#,#,#,#,#,#,#
#,O,O,#,#,#,#, , ,*,#
#,#,*, , , , , , ,#,#
#,#, , , , ,O, , ,#,#
#,#, , , , ,O, , ,#,#
#, , , ,#, , , , , ,#
#, , , ,#, , , , , ,#
#, ,S,#,#,#,#, ,#,*,#
#, , ,#, , , , ,#,O,#
#, , ,*, ,#,#,#,#, ,#
#,#,#,#,#,#,#,#,#,#,#