###,###,###,###,###,###,###,###,###,###,###,###,###,###,###
###,*0 ,   ,   ,   ,   ,   ,###,   ,   ,   ,   ,   ,   ,###
###,###,###,   ,   ,   ,   ,###,   ,   ,   ,   ,   ,   ,###
###,   ,   ,   ,   ,   ,O01,###,   ,   ,   ,###,###,###,###
###,   ,###,   ,   ,   ,   ,   ,   ,   ,   ,   ,   ,   ,###
###,   ,###,###,###,###,###,###,###,   ,   ,   ,   ,   ,###
###,   ,   ,   ,   ,   ,   ,   ,   ,   ,   ,   ,   ,   ,###
###,O00,   ,   ,   ,   ,   ,   ,   ,   ,   ,   ,   ,   ,###
###,###,   ,S2 ,   ,   ,   ,   ,   ,   ,###,   ,   ,   ,###
###,###,###,###,###,###,###,###,###,###,###,###,###,###,###