###,###,###,###,###,###,###,###,###,###,###,###,###,###,###,###,###
###,   ,   ,   ,   ,   ,   ,   ,###,P 1,   ,   ,   ,   ,O  ,*  ,###
###,   ,   ,   ,   ,   ,   ,   ,###,   ,   ,   ,   ,   ,   ,   ,###
###,   ,   ,   ,   ,   ,   ,   ,###,   ,   ,   ,   ,   ,   ,   ,###
###,   ,   ,   ,   ,   ,   ,   ,###,   ,   ,   ,   ,   ,   ,   ,###
###,P 0,   ,   ,   ,   ,   ,   ,###,   ,   ,   ,   ,   ,   ,P 0,###
###,   ,   ,   ,   ,###,###,###,###,   ,   ,   ,   ,   ,   ,   ,###
###,   ,   ,   ,   ,   ,   ,   ,   ,   ,   ,   ,   ,   ,   ,   ,###
###,   ,   ,   ,   ,   ,   ,   ,   ,   ,   ,O  ,   ,   ,   ,   ,###
###,   ,   ,   ,   ,   ,   ,   ,   ,   ,   ,O  ,   ,   ,   ,   ,###
###,O  ,   ,   ,   ,   ,P 1,   ,   ,   ,   ,O  ,   ,   ,   ,S  ,###
###,###,###,###,###,###,###,###,###,###,###,###,###,###,###,###,###