###,###,###,###,###,###,###,###,###,###,###,###,###,###,###,###,###,###
###,###,###,###,###,###,###,   ,   ,O  ,   ,   ,   ,###,   ,   ,S2 ,###
###,###,###,###,###,###,###,   ,   ,   ,   ,   ,   ,###,O  ,   ,   ,###
###,###,###,###,###,###,###,###,   ,   ,   ,   ,   ,###,###,###,   ,###
###,O  ,###,   ,   ,   ,   ,   ,   ,   ,###,   ,   ,   ,   ,   ,   ,###
###,   ,   ,   ,###,   ,   ,   ,   ,   ,   ,   ,   ,###,###,###,###,###
###,   ,   ,   ,   ,###,###,   ,   ,   ,   ,   ,   ,###,###,###,###,###
###,   ,   ,###,   ,   ,###,###,   ,###,###,###,   ,   ,   ,   ,   ,###
###,   ,   ,   ,   ,   ,###,   ,   ,###,###,###,   ,   ,###,   ,   ,###
###,   ,   ,   ,   ,###,###,   ,   ,###,###,###,   ,   ,###,   ,   ,###
###,###,###,###,   ,###,###,   ,   ,   ,   ,   ,   ,   ,###,   ,   ,###
###,###,###,###,   ,###,###,###,   ,###,###,###,###,###,###,   ,   ,###
###,*0 ,###,   ,   ,###,   ,   ,   ,   ,###,   ,   ,   ,   ,   ,   ,###
###,   ,   ,   ,   ,   ,O  ,   ,###,   ,   ,   ,   ,###,   ,   ,   ,###
###,###,###,###,###,###,###,###,###,###,###,###,###,###,###,###,###,###