###,###,###,###,###,###,###,###,###,###,###,###,###,###,###
###,###,###,###,   ,   ,   ,   ,   ,   ,###,   ,   ,   ,###
###,###,###,###,   ,   ,   ,   ,   ,   ,   ,   ,   ,   ,###
###,###,###,###,   ,   ,   ,###,   ,   ,   ,###,O 0,   ,###
###,   ,   ,   ,   ,   ,   ,###,*0 ,   ,   ,###,   ,   ,###
###,   ,   ,   ,   ,   ,   ,###,###,###,###,###,   ,O 1,###
###,   ,   ,O 1,   ,   ,   ,   ,   ,   ,   ,   ,   ,   ,###
###,   ,   ,   ,   ,###,   ,   ,   ,   ,   ,   ,   ,   ,###
###,   ,   ,   ,   ,###,O 2,   ,   ,S2 ,   ,   ,###,###,###
###,###,###,###,###,###,###,###,###,###,###,###,###,###,###