###,###,###,###,###,###,###,###,###,###,###,###,###
###,O  ,   ,P 0,P 1,P 2,P 3,P 4,P 5,P 6,   ,O  ,###
###,*  ,   ,   ,   ,   ,   ,   ,   ,   ,   ,   ,###
###,   ,   ,   ,   ,   ,   ,   ,###,   ,   ,*  ,###
###,*  ,   ,   ,   ,   ,   ,   ,   ,###,   ,   ,###
###,   ,   ,   ,   ,   ,###,   ,   ,   ,   ,*  ,###
###,*  ,   ,   ,   ,   ,   ,###,   ,   ,   ,   ,###
###,   ,   ,   ,###,   ,   ,   ,   ,   ,   ,*  ,###
###,*  ,   ,   ,   ,###,   ,   ,   ,   ,   ,   ,###
###,   ,   ,   ,   ,   ,   ,   ,   ,S  ,   ,*  ,###
###,O  ,   ,P 0,P 1,P 2,P 3,P 4,P 5,P 6,   ,O  ,###
###,###,###,###,###,###,###,###,###,###,###,###,###