#,#,#,#,#,#,#,#,#,#,#,#,#,#,#,#,#
#,#,#,#,#,#,O0,#,#,#,O0,#,#,#,#,#,#
#,#,#,#,#,#, , ,S, , ,#,#,#,#,#,#
#,#, , , ,#, , , , , ,#, , , ,#,#
#, , ,#, , , , , , , , , ,#, , ,#
#, , ,O0, ,#, ,#,#,#, ,#, ,O0, , ,#
#,#, ,*, , ,#,#,#,#,#, , ,*, ,#,#
#,#,#, , , , ,O00,O01,O00, , , , ,#,#,#
#,#,#,#, , , , , , , , , ,#,#,#,#
#,#,#, , ,#,#,#,#,#,#,#, , ,#,#,#
#,*, , , , , , ,#, , , , , , ,*,#
#, , , , ,#, , , , , ,#, , , , ,#
#, ,#,O,#,O0, , , , , ,O0,#,O,#, ,#
#, , , , ,*, , , , , ,*, , , , ,#
#,#, , , , ,*, , , ,*, , , , ,#,#
#,#,#,#,#,#,#,#,#,#,#,#,#,#,#,#,#