###,###,###,###,###,###,###,###,###,###,###,###,###,###
###,O  ,   ,###,P 6,###,   ,   ,   ,   ,   ,   ,   ,###
###,   ,   ,###,   ,###,   ,   ,   ,   ,   ,   ,   ,###
###,   ,   ,###,   ,###,   ,###,###,###,O  ,   ,   ,###
###,   ,   ,   ,   ,###,   ,   ,   ,   ,   ,   ,   ,###
###,S  ,   ,   ,   ,###,   ,   ,   ,   ,*  ,   ,P 6,###
###,###,###,###,###,###,###,###,###,###,###,###,###,###