###,###,###,###,###,###,###,###,###,###,###,###,###,###,###
###,###,###,###,   ,   ,   ,   ,   ,   ,   ,###,   ,S0 ,###
###,###,###,###,   ,   ,   ,   ,###,O 2,   ,###,   ,   ,###
###,###,###,###,   ,   ,   ,###,###,###,   ,###,###,   ,###
###,O  ,   ,   ,   ,   ,   ,###,###,###,*3 ,###,   ,   ,###
###,   ,   ,   ,   ,   ,   ,   ,   ,   ,O 0,###,   ,###,###
###,   ,   ,O 1,   ,   ,   ,   ,   ,   ,   ,###,   ,   ,###
###,   ,   ,   ,   ,###,###,   ,   ,   ,   ,   ,   ,   ,###
###,   ,   ,   ,   ,###,###,   ,   ,   ,   ,   ,   ,O  ,###
###,###,###,###,###,###,###,###,###,###,###,###,###,###,###