###,###,###,###,###,###,###,###,###,###,###,###,###,###,###
###,S0 ,###,   ,   ,###,###,###,   ,   ,   ,   ,   ,   ,###
###,   ,###,   ,   ,###,###,###,   ,*1 ,###,###,   ,   ,###
###,   ,###,   ,   ,   ,O 1,###,###,###,###,###,   ,   ,###
###,   ,###,   ,   ,   ,   ,###,###,###,###,###,   ,   ,###
###,   ,###,###,   ,   ,   ,   ,   ,   ,   ,   ,   ,   ,###
###,   ,   ,   ,   ,###,   ,   ,   ,   ,   ,   ,   ,   ,###
###,###,###,   ,   ,###,###,   ,   ,   ,   ,   ,   ,   ,###
###,   ,   ,   ,O02,###,###,   ,   ,   ,###,   ,   ,O20,###
###,###,###,###,###,###,###,###,###,###,###,###,###,###,###