#,#,#,#,#,#,#,#,#,#,#
#,#,#,O,#,#,#,O,#,#,#
#,#, , ,*,#,*, , ,#,#
#, , , , , , , , , ,#
#, , , ,#,#,#, , , ,#
#,#, , , ,S, , , ,#,#
#,#,#,*, , , ,*,#,#,#
#,#,#,#, , , ,#,#,#,#
#,#,#,#,#,O,#,#,#,#,#
#,#,#,#,#,#,#,#,#,#,#