#,#,#,#,#,#,#,#,#,#,#,#,#,#,#,#
#, , , , , , , , , ,#, , ,*, ,#
#, , , ,#, , , , , , , , ,#, ,#
#, ,*, , , ,O,#, , , , , , , ,#
#, , ,#, , , , , , , ,#,*, , ,#
#, , , , ,*, , , , , , , , , ,#
#, , , ,*, , , , , ,*, , ,O, ,#
#, , , , ,O,#,S, , , , , , , ,#
#,#,#,#,#,#,#,#,#,#,#,#,#,#,#,#