#,###,###,###,###,###,###,###,###,###,###,###,#
#,P 6,   ,###,   , O ,   ,P 6,###,   ,*  ,   ,#
#,   ,   ,###,   ,   ,   ,   ,###,   ,   ,   ,#
#,   ,   ,###,   ,   ,   ,   ,###, * ,   ,   ,#
#,S  ,   ,###,   ,P 1,   ,   ,###, O ,   ,P 1,#
#,###,###,###,###,###,###,###,###,###,###,###,#