###,###,###,###,###,###,###,###,###,###,###,###,###,###,###
###,###,###,###,   ,   ,   ,   ,   ,   ,   ,   ,   ,O30,###
###,###,   ,S1 ,   ,###,###,   ,###,###,###,   ,   ,   ,###
###,###,   ,###,   ,###,###,   ,   ,   ,###,   ,   ,   ,###
###,###,   ,###,   ,###,###,###,###,   ,###,   ,   ,   ,###
###,###,   ,###,   ,###,   ,   ,   ,   ,###,   ,###,###,###
###,   ,   ,   ,   ,   ,   ,   ,   ,   ,###,   ,O01,O21,###
###,   ,###,###,   ,###,###,   ,###,   ,   ,   ,   ,   ,###
###,   ,   ,   ,   ,O12,###,   ,###,   ,   ,   ,   ,   ,###
###,   ,###,   ,   ,O32,###,   ,###,   ,   ,   ,   ,   ,###
###,   ,###,###,###,###,###,   ,###,   ,   ,   ,###,   ,###
###,   ,   ,   ,   ,   ,   ,   ,###,###,   ,   ,###,*0 ,###
###,###,###,###,###,###,###,###,###,###,###,###,###,###,###