#,#,#,#,#,#,#,#,#
#, , ,#, , , ,*,#
#,*, ,#, ,O, , ,#
#, ,O,#, ,#,#,#,#
#, , , ,S, , , ,#
#, , , , ,#,O, ,#
#, , , , ,#, ,*,#
#,#,#,#,#,#,#,#,#