###,###,###,###,###,###,###,###,###,###,###,###,###,###,###,###,###,###
###,S  ,   ,   ,   ,   ,###,   ,   ,   ,   ,   ,   ,   ,   ,   ,   ,###
###,   ,   ,   ,   ,   ,   ,   ,   ,*  ,   ,   ,   ,   ,P 3,   ,   ,###
###,   ,   ,   ,   ,   ,   ,   ,*  ,   ,   ,   ,O  ,   ,   ,   ,   ,###
###,   ,*  ,P 6,   ,   ,   ,   ,   ,   ,P 1,   ,   ,   ,   ,   ,   ,###
###,   ,   ,   ,   ,###,   ,   ,   ,   ,   ,   ,   ,   ,   ,   ,   ,###
###,   ,*  ,   ,   ,   ,   ,   ,   ,###,   ,   ,   ,P 6,   ,   ,   ,###
###,   ,   ,   ,   ,   ,   ,*  ,   ,   ,   ,   ,   ,   ,   ,   ,###,###
###,   ,O  ,   ,   ,   ,   ,   ,   ,   ,P 3,   ,   ,   ,   ,   ,   ,###
###,   ,   ,   ,   ,P 1,   ,   ,   ,*  ,   ,   ,   ,   ,   ,   ,   ,###
###,O  ,   ,   ,   ,   ,   ,   ,   ,   ,   ,   ,   ,   ,*  ,O  ,   ,###
###,###,###,###,###,###,###,###,###,###,###,###,###,###,###,###,###,###