#,#,#,#,#,#,#,#,#,#,#,#,#,#,#,#,#,#,#
#,*, , , , , , , , ,#,#,#,#,#,#,#,#,#
#, ,#,#,#,#,#,#,O, ,#,#,#,#,#,#,#,#,#
#, ,#,#,*, , ,#,#, , , , , , ,#,#,#,#
#, ,#,#, , , , , , ,#,#,#,#, ,#,#,#,#
#, ,O,#, , ,#,#,#, ,O,#,#,#, ,#,#,#,#
#, ,#,#, , ,#,#,#, , , ,*, , ,#,#,#,#
#, , , , , ,#,#,#,#,#,#, ,O, , , , ,#
#,#,#,#, ,#,#,#,#,#,#,#, ,#,#,#,O, ,#
#,#,#,#, ,#,#,#,#,#,#,#, ,#,#,#, , ,#
#,#, , , , ,#,#, , , , , , ,#,#, ,#,#
#,#, , , , ,#,#, ,#,#,#,#, , , , ,#,#
#,#, , ,S, , , , ,#,#,#,#, , , , ,#,#
#,#, , , ,O, ,O, ,#,#,#,#, , , ,*,#,#
#,#,#,#, , , , , ,#,#,#,#, ,#,#,#,#,#
#,#,#,#, , ,*, , , , , , , ,#,#,#,#,#
#,#,#,#,#,#,#,#,#,#,#,#,#,#,#,#,#,#,#