###,###,###,###,###,###,###,###,###,###,###,###,###,###
###,O  ,   ,###,P 6,###,P 2,   ,## ,   ,   ,#  ,*  ,###
###,   ,   ,###,   ,###,   ,   ,   ,   ,   ,#  ,   ,###
###,P 1,   ,###,   ,###,   ,###,###,###,O  ,#  ,P 5,###
###,   ,   ,   ,   ,###,   ,O  ,O  ,   ,   ,###,###,###
###,#  ,   ,   ,   ,###,   ,   ,   ,   ,   ,   ,   ,###
###,   ,   ,   ,   ,###,   ,   ,   ,   ,   ,P 5,   ,###
###,P 0,   ,   ,#  ,###,###,   ,   ,   ,   ,   ,#  ,###
###,###,###,###,###,###,   ,   ,#  ,   ,   ,   ,   ,###
###,P 1,   ,   ,P 0,###,   ,   ,   ,   ,   ,   ,   ,###
###,   ,   ,   ,   ,###,   ,   ,   ,   ,   ,   ,   ,###
###,S  ,   ,   ,   ,###,   ,   ,   ,P 2,   ,   ,P 6,###
###,###,###,###,###,###,###,###,###,###,###,###,###,###