#,###,###,###,###,###,###,###,###,###,###,###,#
#,P 0,   ,   ,   ,   ,   ,   ,#  ,   ,   ,P 1,#
#,   ,   ,   ,###,###,###,   ,   ,   ,   ,   ,#
#,   ,   ,   ,###,O  ,###,   ,   ,###,###,###,#
#,   ,   ,   ,###,   ,###,   ,   ,###,   ,   ,#
#,   ,   ,   ,###,   ,###,   ,   ,###,   ,   ,#
#,S  ,   ,   ,###,P 0,###,   ,   ,###,*  ,P 1,#
#,###,###,###,###,###,###,###,###,###,###,###,#