###,###,###,###,###,###,###,###,###,###,###,###,###,###,###,###,###,###,###,###,###
###,###,###,   ,   ,   ,   ,   ,   ,   ,###,   ,   ,   ,   ,   ,   ,   ,   ,O  ,###
###,###,###,###,   ,###,   ,   ,   ,O  ,###,   ,   ,   ,   ,   ,   ,   ,###,   ,###
###,###,###,###,   ,###,   ,###,###,###,###,O  ,   ,   ,   ,###,   ,###,###,   ,###
###,   ,   ,   ,   ,###,   ,###,###,###,###,###,###,   ,   ,###,   ,   ,   ,   ,###
###,###,   ,   ,   ,   ,   ,   ,   ,   ,###,###,###,###,   ,###,###,   ,   ,   ,###
###,   ,   ,   ,   ,   ,   ,   ,###,   ,###,   ,   ,   ,   ,###,   ,   ,###,   ,###
###,   ,   ,   ,   ,###,###,   ,###,   ,   ,   ,###,   ,   ,###,   ,   ,###,   ,###
###,S  ,   ,   ,O  ,###,###,O  ,###,   ,   ,   ,###,   ,   ,   ,   ,   ,###,*0 ,###
###,###,###,###,###,###,###,###,###,###,###,###,###,###,###,###,###,###,###,###,###